13 ContributorsFebruary 2022 Singles Release Calendar Lyrics2/1
Arlo Parks - "Softly"
BIG30 - "Protest"
DEKKO - "Kelede"
Duwap Kaine - "Free the Innocent"
Jim-E Stack - "Next To Me" ft. Lucky Daye
KESHORE - "Racks Bring the Rats"
Luna Li & Beabadoobee - "Silver Into Rain"
Mili - "Sideshow Duckling"
Ravyn Lenae - "Skin Tight" ft. Steve Lacy
Selfmxdebless - "COUPE"
2/2
22Gz - "Said It's Lit"
100K Track - "Tears of Joy" ft. Rico Cartel & Hotboii
03 Greedo & Mike Free - "Pourin" ft. BlueBucksClan
A Great Big World & Jason Mraz - "Darling It's Over"
Alfie Templeman - "Broken"
Calboy - "Back Again Freestyle" ft. Neil Gang
Feby - "Coming Out"
Flume - "Say Nothing" ft. MAY-A
Hope Tala - "Party Sickness"
Jennifer Lopez & Maluma - "Marry Me (Kat & Bastian Duet)"
Joel Corry - "Liquor Store"
Juice WRLD - "Cigarettes"
Kamasi Washington - "The Garden Path"
Lucy Dacus - "Kissing Lessons"
Maniac - "RABBIT ウサギ"
​midwxst - "​riddle"
Röyksopp - "Impossible" ft. Alison Goldfrapp
Running Touch - "Come With Me"
SAINt JHN - "For the Squadron"
Soulja Boy - "Walk Em Down"
Tai'Aysha - "One Night Ting" ft. Saweetie
YNW BSlime - "Freestyle LOL 2"
2/3
Alex Sensation, Farruko & Prince Royce - "After Party" ft. Mariah Angeliq & Kevin Lyttle
ArrDee & Aitch - "War"
BENEE - "Beach Boy"
Ely Blancarte & Kim Loaiza - "Salvaje"
Ingratax & Sael - "Noche en LA"
Kenia OS & Snow Tha Product - "Joder"
Koffee - "Pull Up"
Llane, Reik & KHEA - "Alcancía"
Mallrat - "Your Love"
Manuel Turizo - "De 100 a 0"
Oliver Tree - "Freaks & Geeks"
Peach PRC - "God Is A Freak"
Peking Duk - "Honest" ft. Slayyyter
Rolling Blackouts Coastal Fever - "The Way It Shatters"
Rusherking & Tiago PZK - "NOW"
​SSGKobe - "\RUNNING OUT OF TIME/"
The Change & Leon Leiden - "Niña de Mis Ojos"
Wallows - "Especially You"
2/4
12AM, Tyla Yaweh & Pressa - "Showgirls"
Ali Gatie - "Perfect"
Alok - "Side Effect" ft. Au/Ra
Arizona Zervas - "BAND$"
Beéle - "Enchulao" ft. Blessd
BigKayBeezy - "Glock 9" ft. Lil Zay Osama
BLCKK - "CRV"
Calum Scott - "If You Ever Change Your Mind"
Chesca - "Soltera"
Clara - "Energies Don't Lie"
Conway the Machine, Benny The Butcher & Westside Gunn - "John Woo Flick"
Curren$y & The Alchemist - "Half Moon Mornings"
Danny Beau - "golden age"
Desiigner - "BAKIN" ft. Slushii & DJ Whoo Kid
E-40 - "It's Hard Not To" ft. Sada Baby
EDDISON - "ok!"
Edurne & Antonio José - "El Amor No Existe"
G Herbo - "Locked In"
Hardo - "Bottom Of The Trap" ft. EST Gee & Icewear Vezzo
Jason Aldean - "Rock And Roll Cowboy"
Jax Jones - "Where Did You Go?" ft. MNEK
Jay Critch & Harry Fraud - "Born With It"
John Legend, Nas & Florian Picasso - "Tomorrow"
Kae Tempest - "Salt Coast"
keshi - "TOUCH"
King Von & 21 Savage - "Don't Play That"
Labrinth - "I'm Tired"
Labrinth - "Yeh I Fuckin' Did It"
Liam Gallagher - "Everything's Electric"
Lights - "Salt and Vinegar"
Lupe Fiasco - "Hustlaz"
Lyn Lapid - "I Guess That Was Goodbye"
Machine Gun Kelly & WILLOW - "emo girl"
Mak Sauce & Blueface - "Blah Blah Blah"
María León & Yuri - "Te Quedas Sin Mí"
Megan Thee Stallion - "Flamin' Hottie"
Nick Cannon & Rick Ross - "My Pimpin" ft. ItsAMovie
Nicki Minaj & Lil Baby - "Do We Have a Problem?"
nothing,nowhere. - "sledgehammer"
Queen Naija & Big Sean - "Hate Our Love"
Rafa Pabön, Dalex & De La Ghetto - "La Cartera (Remix)"
Red Hot Chili Peppers - "Black Summer"
ROSALÍA - "SAOKO"
Russ - "HANDSOMER"
Sarai - "Una Noche Más"
$NOT & A$AP Rocky - "Doja"
Sofi Tukker - "Original Sin"
Spider Gang - "​​the napoleonic wars"
Supa Bwe - "ACAB" ft. DINO7K, Chance the Rapper & redveil
Tate McRae - "she's all i wanna be"
Tay Money & Saucy Santana - "Hello"
Tokio Hotel - "Bad Love"
Tommy Genesis - "a woman is a god (Remix)" ft. BIA
Thitis, Dj Scumvag - "Bullmastiff"
Warren Hue - "RUNAWAY W ME"
Winnetka Bowling League & Demi Lovato - "fiimy"
​wolfacejoeyy - "​tic tac toe"
YG - "Scared Money" ft. Moneybagg Yo & J. Cole
YN Jay - "Tip Off" ft. Mozzy & Louie Ray
Yung Gravy, T-Pain & Dillon Francis - "Hot Tub"
2/5
Chris Brickley & Lil Durk - "Ikea Rug"
MAJ - "Lately/Queen 2"
2/6
Danny Ocean - "Istanbul"
Kankan - "AP Skelly"
2/7
AGA 江海迦 - "Tomorrow"
alt-J - "The Actor"
Anastacia - "American Night"
Bree Runway - "Pressure"
Everything Everything - "Bad Friday"
王菀之 (Ivana Wong) - "狠愛狠愛你 (Hate Love Hate Love You)"
Rauw Alejandro - "Caprichoso"
2/8
Brahman - "​reminding"
Calboy - "Too Easy Freestyle"
Ed Schrader's Music Beat - "Echo Base"
Kodak Black - "Grinding All Season"
mxmtoon - "mona lisa"
ODESZA - "The Last Goodbye" ft. Bettye LaVette
paopao & iZaak - "tenemos que hablar"
Pollari - "SRT!"
Pusha T - "Diet Coke"
張蔓莎 (Sabrina Cheung) - "剎那的 (I Like Being Yours)"
Sharon Van Etten - "Porta"
YoungBoy Never Broke Again - "Mr Grim Reaper"
2/9
100K Track, YNW BSlime & Slatt Zy - "Change"
Caroline Polachek - "Billions"
Derivakat - "Tell Your Story (Extended)"
DJ Chose & Fredo Bang - "She Luv Me"
梁詠琪, 吳君如 & 呂爵安 (Gigi Leung, Sandra Ng & Edan Lui) - "辣到出汁 (Spice in My Bones)"
Nerea Rodríguez - "Señales"
Ogi - "I Got It"
Omar Apollo - "Invincible" ft. Daniel Caesar
Pamungkas - "Please Baby Please"
Portugal. The Man - "What, Me Worry?"
Quando Rondo - "Jahkiyah"
​tomcbumpz, Ivri & Souly Had - "we don't know a thing"
2/10
Becky G & KAROL G - "MAMIII"
Central Cee - "Khabib"
FMK - "Pal Carajo el Amor"
Foals - "2am"
Kali - "UonU" ft. Yung Bleu
Lali - "Como Tú"
LIT killah - "La Trampa es Ley"
Luis Fonsi & Cali y El Dandee - "Ley de Gravedad"
M Huncho - "Warzone" ft. Headie One
Migrantes, MYA & Luck Ra - "Lado Triste (Remix)"
OhGeesy - "Appetizer"
Ovi & Kim Loaiza - "Después de las 12"
Sofía Reyes & María Becerra - "Marte"
The Hertz - "Now Here, Man!"
Wisin & Yandel - "NO SE OLVIDA"
2/11
88GLAM - "Want To"
Abraham Mateo, L-Gante & Omar Montes - "Vamos Que Nos Vamos"
Alok & Rooftime - "Keep Walking"
Autumn! - "Bentley Bentayga!"
AViVA & The Tech Thieves - "BROKEN"
Blac Youngsta & 42 Dugg - "Threat"
BlueBucksClan - "Valentines Day"
Call Me Karizma - "Dead Body"
Curren$y & The Alchemist - "The Tonight Show"
CXRPSE - "TOO LATE"
DC The Don - "PSA"
Diplo & Miguel - "Don't Forget My Love"
Doja Cat - "Celebrity Skin"
Dove Cameron - "Boyfriend"
Duke Deuce - "Falling Off" ft. Rico Nasty
Ed Sheeran - "The Joker and the Queen (Remix)" ft. Taylor Swift
EDDISON - "Dope Boi" ft. Plsbug
Felix Cartal & Elohim - "Nothing Good Comes Easy"
Fireboy DML, 21 Savage & Blxst - "Peru (Remix)"
Fivio Foreign, Kanye West & Alicia Keys - "City of Gods"
Francisca Valenzuela - "Como La Flor"
Future - "Worst Day"
Immasoul & Sobrino - "Secreto"
Internet Money & 24kGoldn - "Options"
Ivan Cornejo - "Perro Abandonado"
J Alvarez - "Historia Sin Fin"
KayCyy & Gesaffelstein - "OKAY!"
Ken-Y - "Falsas Palabras"
Kevo Muney - "No Way"
Kiiara - "Miss Me"
Leli Hernández & Play-N-Skillz - "F-U"
Lennis Rodriguez & Chus Santana - "Mírame a la Cara"
Lil PJ - "Leveled Up" ft. Lil Keed
Lul Bob - "Best End"
Maren Morris - "Background Music"
Mozzy - "Real Ones" ft. Roddy Ricch
Nicki Minaj & Lil Baby - "Bussin"
Nina Nesbitt - "When You Lose Someone"
Pardison Fontaine - "Hoop Earrings"
Rema - "Calm Down"
Ron Suno - "GOAT"
Sada Baby - "Perfect Form Skub"
Saweetie - "Closer" ft. H.E.R.
Shealeigh - "Here Again"
Slatt Zy - "Hard to Live"
Slump6s - "Presidential"
St. Lucia - "Rocket on My Feet"
​vf7 - "Tal Vez"
Vibarco - "Cabrón"
Yeat - "Still Countin"
2/12
Natalie Imbruglia - "Story of My Life"
Popcaan & Imeru Tafari - "Elevate"
Sadie - "Queen"
2/13
Kankan - "GET TROLLED"
Skeng - "Rain Like Hail"
Warren G - "Life Is Beautiful"
2/14
Amarion & Omy De Oro - "Trambo"
Black Birdie - "fiction"
Big Yavo - "Fronted"
Cazzu - "C14TORCE V: Baladas para un Alien"
Chris Andrew - "Mató a Cupido"
Chronic Law - "Corrupt"
COLLAR - "Call My Name! (COLLAR214 ver.)"
Desiigner & Tank God - "Put Her On"
Dexta Daps - "Rough Day Rough Night"
Duki & Emilia - "Esto Recién Empieza"
Eix, De La Ghetto & Maffio - "60 Segundos"
Future Islands - "King of Sweden"
Gareth.T - "​dinner in bed"
GRECIA - "Bonito"
Gunna - "Banking On Me"
陳卓賢 (Ian Chan) - "留一天與你喘息 (Breathing With You)"
馮允謙 (Jay Fung) - "報復式浪漫 (Sweeetly)"
JC Stewart - "Love Like That"
Kate Stewart - "Hate You"
Ke Personajes, La T & La M - "Ya Fue"
Lil Darkie - "fly away"
NateWantsToBattle - "Time to Move On"
ReneaNicole - "Overtime"
Rex Orange County - "AMAZING"
Robb Bank$ - "SHOOTOUT" ft. Lil Uzi Vert
Rochy RD - "Mi Mujer"
Rombai - "NO SE RUEGA"
Romeo Santos - "Sus Huellas"
Shenseea - "R U That" ft. 21 Savage
Silk Sonic - "Love's Train"
SoFaygo - "Drop Em" ft. Yung Bans
Tinashe - "Naturally"
Toosii - "Love Me Easy"
Vince Staples & Mustard - "MAGIC"
White Lies - "Blue Drift"
Youngboy Never Broke Again - SuperBowl
2/15
347aidan - "BAD KIDS"
Alexio La Bestia - "Ultram"
Beach House - "Hurts to Love"
Bill Wurtz - "​i’m scared"
Death Cab for Cutie - "Waiting for the Sunrise"
Eliza & The Delusionals - "Give You Everything"
Hatchie - "Giving the World Away"
KESHORE - "different"
Kid Bloom - "Does It Feel Real"
Kurt Vile - "Like Exploding Stones"
LiL CaKe & Nobeat - "Tan Solo Hoy"
Lil Geniuz & Luar La L - "Dinero en Movimiento"
​paopao, La Gabi & Villano Antillano - "hebilla" ft. ARIA VEGA & Cami Da Baby
Sea Girls - "Lonely"
Wallice - "Little League"
2/16
Amenazzy & Beny Jr - "Rulay"
Bear's Den - "Shadows"
Buddy - "Wait Too Long" ft. Blxst
Carla Geneve - "Brighter Than Blue"
Doss - "Jumpin'"
Feby - "What Do You Think"
J Balvin - "Niño Soñador"
Kim Loaiza & JD Pantoja - "INCONDICIONAL"
Lola Indigo - "Las Solteras"
MOTHICA & emlyn - "GOOD FOR HER"
Nilüfer Yanya - "anotherlife"
Pacman da Gunman & Hit-Boy - "Find a Balance" ft. DOM KENNEDY
Reazy Renegade, K CAMP & Rich The Kid - "Ballin (Kevin Durant)"
RUGGERO - "Se Vive Solo una Vida"
Teezo Touchdown - "Handyman"
林家謙 (Terence Lam) - "某種老朋友 (Regression)"
Tessa Violet - "YES MOM"
THE BLSSM - "DIZZY"
TINI & Beéle - "Fantasi"
Tomberlin - "happy accident"
Train - "AM Gold"
Zolita - "Single in September"
2/17
Anitta & Justin Quiles - "Envolver Remix"
Dímelo Flow, Rauw Alejandro & Farruko - "Suelta" ft. Mr. Vegas, María Becerra & Fatman Scoop
Dvicio - "TE PIENSO A CADA HORA"
Ed Sheeran - "Bad Habits (Remix)" ft. Bring Me The Horizon
Fontaines D.C. - "I Love You"
Fredo Bang - "4's Up"
Fuego & Ryan Castro - "Pendiente al Paso"
Goyo - "Na Na Na"
Jack Savoretti - "You Don't Have To Say You Love Me / Io che non vivo senza te (Medley)"
Jon Z & Luar La L - "Bellako Puñeta"
Mahalia - "Letter To Ur Ex"
Morat - "Llamada Perdida"
Nathy Peluso - "EMERGENCIA (Presented by PlayStation, Horizon Forbidden West)"
Ozuna - "Deprimida"
Snow Tha Product & Gera MX - "Wassap"
Troye Sivan & Jay Som - "Trouble"
Trueno, Randy & Bizarrap - "JUNGLE"
Paco Amoroso - "LAION SHUFFLE"
Rei, Kaleb Di Masi & Alan Gomez - "Dale Dale"
​umru, Tony Velour & Fraxiom - "all i need" ft. Hannah Diamond
Winona Oak - "Island of the Sun"
Yumi Zouma - "Where The Light Used To Lay"
2/18
220 KID & Jem Cooke - "Another Life"
3LW - "Trouble"
Abe & Lorena - "Miénteme"
Ainoa Buitrago - "A LO LEJOS"
Alejandro Santamaria - "Despierto"
Alok & Alan Walker - "Headlights" ft. KIDDO
Baby Tate - "Slut Him Out"
Baby Tate - "What's Love?"
C. Tangana, Omar Montes & Daviles de Novelda - "La Culpa" ft. Canelita
Call Me Loop - "Painkiller"
Chappell Roan - "Naked in Manhattan"
Chicocurlyhead - "NO TE VAYAS"
Chris Miles - "Nothing Feels the Same" ft. Lil Tracy
Christian Nodal - "Ya No Somos Ni Seremos"
Clean Bandit - "Everything But You" ft. A7S
COIN - "I Think I Met You in a Dream"
Dave East - "Bet It"
DDG - "Elon Musk" ft. Gunna
Edén Muñoz - "Chale"
ELIO - "Read The Room"
ERROR - "愛情值日生 (Love On Duty)"
flor - "Play Along"
Florrie - "What If I'm Wrong"
Ghastly - "Smoke" ft. Madalen Duke
Gotay "El Autentiko" & Nesi - "Soltero"
Guapdad 4000 - "Ruthless"
Hunxho - "Let’s Get It (Remix)" ft. 21 Savage
Isaac Dunbar - "bleach"
Jack Harlow - "Nail Tech"
JAY MAX - "Pegaíta"
Jessica Taylor - "U Really Think U Love Me"
Jessie Murph - "Pray"
Kayzo - "News Flash" ft. Kamiyada+
Kid Cudi & Nigo - "Want It Bad"
Kojey Radical - "Silk" ft. Masego
Kungs - "Clap Your Hands"
莊正 (Lester Chong) - "裂 (Crack)"
Little Boots - "Out (Out)"
Louie Ray - "Nobody Proud" ft. YN Jay
Louis the Child, Kasbo & EVAN GIIA - "Blow the Roof"
Lucki - "Super Urus"
Lucky Daye - "NWA" ft. Lil Durk
Lukas Graham - "All Of It All"
Matt Paris - "Se Te Nota"
Maude Latour - "Headphones"
MC4D & gavn! - "Still There"
Melii - "Cartier"
merci, mercy - "Why'd You Only Call Me When You're High?"
Mimi Webb - "House On Fire"
​moon tang - "lately"
NGeeYL - "Glock 19"
Nicole Favre & Joey Montana - "Repítelo"
Nothing But Thieves - "Life's Coming in Slow"
PJ Morton & JoJo - "My Peace" ft. Mr. Talkbox
Quin NFN - "Scrimmage" ft. LilCJ Kasino & Lil 2z
Regard - "Hallucination" ft. Years & Years
Robin Thicke & Rapsody - "Day One Friend"
ROLE MODEL - "if jesus saves, she's my type"
Russ - "Real"
RY X - "Let You Go"
Sabrina Carpenter - "Fast Times"
Sara Kays - "When You Look at Me"
Scorey - "Girls Love Rod Wave"
Simple Plan - "Ruin My Life" ft. Deryck Whibley
Sin Bandera - "Dime Que Sí"
Soge Culebra, Mora & GARABATTO - "7 Lágrimas (Remix)"
Stefflon Don - "Like That"
Steve Aoki & grandson - "KULT" ft. Jasiah
The Colleagues - "Rolex" ft. Freddie Gibbs
The Knocks - "Slow Song" ft. Dragonette
Ty Dolla $ign - "Champions" ft. Wiz Khalifa
Unlike Pluto - "Digital Junkie"
​vf7, Lele Pons & Ninow y Candy - "Restart"
Yamil & RKM - "Mi Debilidad"
YNW BSlime - "Valenslime"
2/19
BasedNas - "My Time"
Cold Hart - "STRAWBERRYY"
Mili - "My Creator"
Stunna 4 Vegas - "YNWA"
2/20
Rubi Rose - "I Like"
Since99 - "Slip Away"
YoungBoy Never Broke Again - "Opposite"
2/21
Brytiago - "Reaction"
Chronic Law - "Venom"
Duwap Kaine - "GRG (Get Right Gang)"
EARTHGANG & Musiq Soulchild - "AMEN"
Ele A El Dominio - "Champagne y Cerveza"
Hozwal & Amarion - "INFIELES"
KHEA - "DELITO_V13.wav"
Lil Darkie - "PIGGY BACK"
Porridge Radio - "Back To The Radio"
Pressa - "Hear Me Out"
VenusTheG & ppcocaine - "GET ON (Remix)"
2/22
100K Track & YNW Melly - "Slums"
Carlos Unger - "¿porque me tratas así?"
Chesca - "TuTuRu"
Ego Ella May - "Introvert Hotline"
張蔓姿 (Gigi Cheung) - "不言自明 (Frequency)"
Jensen McRae - "Happy Girl"
李駿傑 (Jeremy Lee) - "半 (Half)"
KAWALA - "Hypnotized"
Kenny Mason - "LIFT OFF FREESTYLE"
徐嘉浩 (Kevin Kaho Tsui) - "By The Time"
Kodak Black - "I Wish"
LAY & 24kGoldn - "Dawn to Dusk"
Lil Durk - "AHHH HA"
Malu Trevejo - "Culo Chapa" ft. La Perversa, Quimico Ultra Mega & Haraca Kiko
María Becerra - "Felices x Siempre"
Mura Masa, Lil Uzi Vert & PinkPantheress - "bbycakes" ft. Shygirl
Natti Natasha, El Alfa & Chimbala - "WOW BB"
Nohemy - "NOH"
Regina Spektor - "Becoming All Alone"
Toro y Moi - "The Loop"
WHIZZ - "二話都說 (In Our Private Zone)"
YoungBoy Never Broke Again - "I Hate YoungBoy"
2/23
CMAT - "Every Bottle (Is My Boyfriend)"
COBRAH - "GOOD PUSS (Remix)" ft. cupcakKe
ericdoa - "fool4love"
Florence + the Machine - "King"
Gang of Youths - "spirit boy"
Girlpool - "Dragging My Life Into a Dream"
Jewel - "Dancing Slow" ft. Train
Lil Tracy - "Not Just Anybody"
Lizzy McAlpine - "reckless driving" ft. Ben Kessler
​midwxst - "i know you hate me"
NoCap - "I'll Be Here"
Pollari & Yung Beef - "Earth (Remix)"
Quando Rondo - "Six-0 Business"
​salem ilese, TOMORROW X TOGETHER & Alan Walker - "PS5"
Soulja Boy - "Goin Down (Young Joc)"
Soulja Boy - "Lion"
The Vaccines - "Thunder Fever"
Troye Sivan & Gordi - "Wait"
Yungeen Ace - "My Own Problems"
2/24
Aleesha, NICKI NICOLE & Taichu - "Arrepentío" ft. Juicy BAE
georgee - "split"
Denzel Curry - "Zatoichi" ft. slowthai
GIULIA BE - "2 PALABRAS"
Hannah Diamond - "Staring at the Ceiling"
Kaleb Di Masi, Alejo Isakk & Omar Varela - "P rreo" ft. Salastkbron
Kehlani - "little story"
LightSkinKeisha - "Play Me"
Lil B - "Pushing Peace"
MKULTRA - "In a Rut"
Rauw Alejandro - "GRACIAS POR NADA"
ROSALÍA - "CHICKEN TERIYAKI"
Soulja Boy - "Liu Kang"
Spider Gang - "NO EFFORT"
岑寧兒 (Yoyo Sham) - "無常家 (Born on 00.00.00)"
2/25
Ache - "Panas Con Privilegios"
Alan Wittels - "SESENTAYNUEVE"
Alec Benjamin - "Shadow Of Mine"
盧瀚霆 (Anson Lo) - "Mr. Stranger"
ArrDee ft. Lil Tecca - Flowers (Say My Name)
Autumn! - "Jumpin!"
BabySantana - "​nyc"
BANKS - "Holding Back"
Becky Hill & Galantis - "Run"
Big Time Rush - "Not Giving You Up"
Big Yavo - "Lumberjack"
Brevin Kim & Curtis Waters - "ALIENSPEAK"
Cali y El Dandee - "Malibu"
Cavetown & beabadoobee - "Fall in Love With a Girl"
Cosculluela - "La Que Hay"
E20 - "Memphis Memphis Memphis" ft. Yo Gotti
Erica Banks - "Slim Waist"
Fefe Dobson - "Fuckin In Love
Felix Jaehn & The Stickmen Project - "Rain In Ibiza" ft. Calum Scott
Flo Milli - "PBC"
G Flip - "GAY 4 ME"
Gente De Zona - "Q'lona"
GRIP - "Emo Stick"
HD4President - "One Mic"
Hollywood Undead - "CHAOS"
Jackboy - "All We Got"
Jasiah - "Earthquake" ft. jxdn
Javiielo - "BRÚJULA"
Joshua Bassett - "Doppelgänger"
Juanka - "Pasaporte"
Karlae - "Blind" ft. Lil Yachty
Kilo Kish - "NO APOLOGY!"
Knightlight - "White Lies"
Kygo - "Dancing Feet" ft. DNCE
Lennis Rodriguez & Chus Santana - "La Canción X (Reclamo)"
Maná & Christian Nodal - "Te Lloré Un Río"
Matt Citron - "Far From You"
Matt Citron - "Air It Out
Mooski - "Scuba Diving"
Morad - "No y No"
Naty Botero - "Puro Amor"
Nessa Barrett - "dying on the inside"
OneRepublic - "West Coast"
Pekeño 77 & Marcianeke - "Envidia y Maldad"
Piso 21, KHEA & Marc Seguí - "Mató Mi Corazón (Parte II)"
Rae Morris - "No Woman Is An Island"
Ramon Vega & Kenia OS - "Tírame Un Hello (Remix)"
Rexx Life Raj - "Balance"
Russ - "WHAT ARE YALL"
Ryan Castro - "Clásico" ft. Ovi
Sam & La S - Efecto
陳珊妮 (Sandee Chan) - "痛癮 (Pain Addict)"
Since99 - "Precision"
Sorn - "Sharp Objects"
​SSGKobe - "marni freestyle v1.28.22"
Swedish House Mafia - "Redlight"
Taleban Dooda - "Spin"
Tom Aspaul - "Kiss It"
Tyga & Doja Cat - "Freaky Deaky"
​vf7 & Nio García - "Baila Bien"
​yvngxchris - "​​​​maison mihara​​​​" ft. midwxst
Zyron, Ñengo Flow & Marcianeke - "Bien Mala (Remix)" ft. Ñengo Flow, Jowell, Marcianeke, Cris Mj & Franco "El Gorila"
2/26
Intence - "Puissant"
Lil Tracy - "ⁱ ᵗʰⁱⁿᵏ ⁱ ˢᵒˡᵈ ᵐʸ ˢᵒᵘˡ ❤️‍🩹"
2/28
Apel8 - "Ghoul"
Beam - "Bow"
Corina Smith & Eladio Carrión - "Roto"
Dee Watkins - "Realer and Realer" ft. Jackboy
Eliel MX - "Fuego"
Lil Darkie - "​sun come up"
Lil Tracy - "RED LIKE BLOOD . . . 🧛🏻‍♀️"
Nilüfer Yanya - "the dealer"
POLIÇA - "Rotting"
Stereophonics - "Right Place Right Time"
鄧小巧 (Tang Siu Hau) - "兩種語言 (Two Languages)"
Wet Leg - "Angelica"
Labrinth & Zendaya - "I'm Tired"
Yung Bans - "I Spy" ft. FutureEmbed