9 ContributorsFebruary 2021 Singles Release Calendar Lyrics2/1
A$AP Rocky - "G-Unit Rice"
Drakeo the Ruler - "Too Icey"
Joey Trap - "BIRDIES"
KILL.ZERO - ".:HAUNTR:.+"
koi - "all of that"
Luke Combs & Billy Strings - "The Great Divide"
MonoNeon - "Done with the BS" ft. Ledisi
Steve Aoki & Willy William - "Mambo" ft. Sean Paul, El Alfa, Sfera Ebbasta & Play-N-Skillz
The Bloody Beetroots & Teddy Killerz - "Elevate"
TOBi - "Love Not Blood"
Victoria Monét - "F.U.C.K."
Wiz Khalifa - "Chicken with the Cheese" ft. Chevy Woods & 24hrs
2/2
Ben Howard - "Crowhurst's Meme"
Dolly Parton - "5 to 9"
Indii G. - "Drifting"
Kito, VanJess & Channel Tres - "Recap"
Leslie Odom Jr. - "Beautiful Things Can Happen"
Luca Yupanqui - "V4.3, Pt. 2"
PlayThatBoiZay - "90'S BABY FREESTYLE"
XANAKIN SKYWOK - "Club Banger!" ft. Billy Marchiafava
youra - "MIMI"
2/3
03 Greedo & Wiz Khalifa - "Substance (We Woke Up)"
Curren$y - "Misty"
Drippin' So Pretty - "Too Sick"
Death From Above 1979 - "One + One"
Ghetts - "No Mercy" ft. BackRoad Gee & Pa Salieu
Ichiko Aoba - "アンディーヴと眠って (Asleep Among Endives)"
Jimmy Edgar - "NOTICE" ft. 24hrs
Jordin Sparks - "You Still Think of Me"
Julien Baker - "Favor"
Lauren Auder - "Heathen"
Moneybagg Yo - "Time Today"
​pluko - "High Hopes" ft. DUCKWRTH & sad alex
Stereolab - "Household Names"
sumika - "祝祭 (shukusai)"
Tkay Maidza & Yung Baby Tate - "KIM"
Trey Songz - "Brain"
Unusual Demont - "Pine"
YBN Almighty Jay - "Battling My Spirit"
YNW BSlime - "OTW"
2/4
BAND-MAID - "About Us"
Daya - "Bad Girl"
Digga D & AJ Tracey - "Bringing It Back"
FINNEAS - "American Cliché"
H.E.R. - "Fight for You"
hololive IDOL PROJECT - "STARDUST SONG" ft. Tokoyami Towa, Shiranui Flare & Amane Kanata
Iglooghost - "Sylph Fossil"
Jack Reynolds - "Sunny Gaze"
Lil Durk - "Love You Too" ft. Kehlani
Lil Playah - "Knocked Off!" ft. OnlyBino
Lucky Daye & Tiana Major9 - "On Read"
MARINA - "Man's World (Empress Of Remix)" ft. Pabllo Vittar
Sam Fischer & Demi Lovato - "What Other People Say"
Sia & David Guetta - "Floating Through Space"
Tino Szn - "Vice" ft. $NOT
Yeek - "3000 Miles (Baby Baby)"
2/5
8 Graves & Saint Slumber - "Guillotine"
88GLAM & 6ixbuzz - "Urgent Messages"
​aespa - "Forever (약속)"
Aidan Alexander - "the end of the world"
Allie X - "GLAM!"
Blssom - "Vas"
Bobby Sessions & Megan Thee Stallion - "I'm a King"
Bob Moses - "The Blame (DJ Seinfeld Remix)"
Bow Wow - "My Pain"
Cardi B - "Up"
Carly Pearce - "Should've Known Better"
Cheat Codes - "Hate You + Love You" ft. AJ Mitchell
Chet Faker - "Get High"
CMTEN - "ALONE" ft. RILEY THE MUSICIAN
Creo - "Aurora"
Dan + Shay - "Glad You Exist"
DBangz - "The Source" ft. Jay Zole
DC the Don - "Rag3 Kidd"
Diplo & Sonny Fodera - "Turn Back Time (Bklava Remix)"
Dream - "Roadtrip" ft. PmBata
DUSTY LOCANE - "Rumble"
Ellise - "Bubblegum Brain"
FCG Heem - "Need It"
Felix Cartal & Kiiara - "Happy Hour"
Flight - "The Whole Team Hit"
Foley - "Better Than Love"
Freddie Gibbs - "Gang Sings" ft. ScHoolboy Q
G-Eazy - "Provide" ft. Mark Morrison & Chris Brown
(G)I-DLE - "HWAA (Dimitri Vegas & Like Mike Remix)"
Goody Grace - "Grape Swisher"
Ice Cube - "Trying to Maintain"
ILLENIUM, Dabin & Lights - "Hearts on Fire (Bassjackers Remix)"
Jazmine Sullivan - "Lost One (Live)"
Jessie Ware - "Remember Where You Are (Edit)"
JID - "Bruuuh (Remix)"
Jim Jones & Harry Fraud - "Lose Lose"
​​johan lenox & Cousin Stizz - "​phases"
Jonas Blue & AWA - "Something Stupid"
Jordan Suaste - "If the World Ended Tonight"
Josef Salvat - "One More Night"
JP THE WAVY - "Lucky Star" ft. Lancey Foux
Kevin Garrett - "Pure Imagination"
Keyshia Cole - "I Don't Want to Be in Love"
KyleYouMadeThat - "Hoopla" ft. NLE Choppa
Like Saturn - "lost happiness"
Louis the Child & BabyJake - "Somewhere Else"
Luke Bryan -  "Country Does"
Martin Garrix - "Pressure" ft. Tove Lo
Miley Cyrus - "Prisoner (Jax Jones Remix)" ft. Dua Lipa
Molly Kate Kestner - "Get Up" ft. Brock Monroe
MonoNeon - "The Little Green Man" ft. Daru Jones
Morray - "Kingdom"
Myuk - "魔法 (Mahou)"
Nessly - "Affairs"
Nessly - "No Reason"
Night Lovell - "Counting Down the List"
Oliver Tree - "Out of Ordinary"
OMB Peezy - "Dope Boy" ft. Rylo Rodriguez
Peso Peso - "Brad Pitt" ft. Trippie Redd
Phora - "Loaded Gun"
Polo G - "GNF (OKOKOK)"
Puma Blue - "Sweet Dreams"
Quelly Woo - "Hot Winter"
Raveena - "Tweety"
Rezz - "Sacrificial" ft. PVRIS
Ricky Montgomery - "Line Without a Hook (Remix)" ft. mxmtoon
Ritt Momney - "Not Around"
Robin Thicke - "Lucky Star"
Ruben - "Mama Don't Know"
SG Lewis & Nile Rodgers - "One More"
Shordie Shordie & Murda Beatz - "LOVE" ft. Trippie Redd
SLANDER & Au5 - "Anywhere" ft. PLYA & shYbeast
Smokepurpp & Lil Mosey - "We Outside"
Teddy Swims - "My Bad"
Tee Grizzley - "Late Night Calls"
Tokyo Machine & Weird Genius - "Last Summer" ft. Lights
Tom MacDonald - "Cancelled"
Tone Stith - "FWM"
VIC MENSA - "SHELTER" ft. Wyclef Jean & Chance the Rapper
Xan Griffin - "Frustrated"
XIX - "Henny Bottle"
Yelawolf & Caskey - "Been a Problem"
Yemi Alafifuni - "Behold the Lamb"
Young Rog & Summer Walker - "Bullshit"
Yung Dred - "Everything's Up" ft. Hotboii
Zella Day - "Holocene" ft. Weyes Blood
2/6
916frosty, ILYMAX & Zcxr - "beem"
Kodak Black - "Every Balmain"
Savage Ga$p - "goodbyes are the hardest part"
2/7
NoCap - "Dismiss You"
Wiz Khalifa - "Dreams" ft. 24hrs
2/8
Brent Faiyaz - "CIRCLES"
Derivakat - "Under the Weather"
Gabrielle - "Stop Right Now"
Pink Sweat$ - "Heaven"
Slim Thug - "#BlackQueen​"
Slowpalace, FWLR & qwinn - "Already Gone"
The Vaccines - "High Horse"
2/9
645AR - "MAMA PRAY"
Capo Lee, Shorty, JME, Frisco - "Baitest Sound"
Dry Cleaning - "Strong Feelings"
Ebhoni - "X-Ting"
ISLAND - "Octopus"
Katy Kirby - "Portals"
Lauren Duski - "I Would For You"
Pale Waves - "Fall to Pieces"
plxntkid- "crucifix"
slowthai & Skepta - "CANCELLED"
Valley - "Like 1999"
2/10
Brad Paisley - "Off Road"
Cherry Glazerr - "Big Bang"
Claud - "Guard Down"
Danny L Harle & DJ Mayhem - "Interlocked"
Danny L Harle & DJ Ocean - "Ocean's Theme"
Dee Watkins - "Make Em Mad"
GRAE - "Soft"
Greta Van Fleet - "Heat Above"
Gryffin & Two Feet - "I Want Love"
Ichiko Aoba - "Asleep Among Endives (demo)"
Invader Kaide & Steele 11 - "SHGO"
Jacob Banks - "Parade"
Kevo Muney - "Leave Some Day (Remix)" ft. Lil Durk
KUČKA - "No Good for Me"
Liz Phair - "Hey Lou"
Luh Kel - "7:26am"
Middle Kids - "Cellophane (Brain)"
Of Mice & Men - "Timeless"
PROM - "Friends"
Rebecca Black - "Friday (Remix)" ft. Dorian Electra, Big Freedia & 3OH!3
Sainvil - "Need 2"
Teezo Touchdown - "Technically"
Tigers Jaw - "New Detroit"
TK from Ling tosite sigure - "unravel (n-buna from ヨルシカ Remix) "
Trippie Redd - "BUZZ"
Unlike Pluto & why mona - "Circular Motion"
2/11
Ashe - "The Same"
COIN - "Sagittarius Superstar" ft. Faye Webster
Danny Elfman - "Love in the Time of Covid"
Dua Lipa - "We're Good"
Eric Bellinger & Hitmaka - "Hit Eazy"
Erica Banks - "Buss It (Remix)" ft. Travis Scott
flora cash - "Feeling So Down"
G-Eazy - "A Little More" ft. Kiana Ledé
Glitterer - "Life is Not a Lesson"
Headie One - "Siberia"
hololive IDOL PROJECT - "Dreaming Days" ft. Amane Kanata, Houshou Marine, Usada Pekora, Oozora Subaru, Yuzuki Choco, Nakiri Ayame, Murasaki Shion, Natsuiro Matsuri & Shirakami Fubuki
joan & BEKA - "brokenhearted (together)"
Kings of Leon - "Echoing"
milk. - You&I
Noga Erez - "End of the Road (Acoustic Live - Kids Against The Machine)"
Rileyy Lanez - "When I See You (Lamont's Song)"
​Ruel - "too many feelings"
Sauce Twinz - "Splash" ft. Trippie Redd
Skrapz - "Jumpout" ft. Nines
Stefflon Don, Tiwa Savage & Rema - "Can't Let You Go (Remix)"
Stephanie Poetri - "IRL"
Tory Lanez - "Mine Still (Freestyle)"
Tristam - "Burn"
2/12
3OH!3 - "LOVE SOMEBODY"
3OH!3 - "TATTOOED HEART"
916frosty - "wow!" ft. Ducey Gold
Alaina Castillo - "stfu (i got u)"
Aloe Blacc & LeAnn Rimes - "I Do"
Aly & AJ - "Pretty Places"
Anne-Marie, KSI, & Digital Farm Animals - "Don't Play (Acoustic)"
Aston Merrygold - "Overboard"
AViVA & Omiki - "EVIL (Remix)"
Bianca - "Gimme"
Biig Piig - "Cuenta Lo"
Birdy - "Loneliness"
Bishop Briggs - "SOMEONE ELSE (Remix)" ft. Jacob Banks
blackwinterwells - "HEARSE" ft. funeral
Carlie Hanson - "I Hate Your Room"
Carly Rose - "First"
Carrie Underwood - "Softly and Tenderly"
Charlotte Cardin - "Meaningless"
Clever - "Rolls Royce Umbrella" ft. Chris Brown
CRAY - "Roses R Red"
Dan Bull - "Living Life in Limbo"
Deadmau5 - "Arguru 2k19"
DJ Pharris - "Everything New" ft. Wiz Khalifa, Chance the Rapper, Rockie Fresh
Doe Boy - "Lowkey" ft. Lil Uzi Vert
Drew Sycamore - "45 Fahrenheit Girl"
Eloise - "Hungover"
FITZ - "Somebody Sometimes"
Futuristic & Michael Minelli - "Waste Your Time"
G-Eazy - "A Little More" ft. Kiana Ledé
Gallant - "Relapse."
gavn! - "crazy (Acoustic) "
George Cosby - "Real Love"
Gordi & Alex Lahey - "Dino's"
Grant & RUNN - "Fix It"
Guapdad 4000 & !llmind - "How Many"
Hauskey - "Go Wrong"
Henry Daher & Ski Mask the Slump God - "Unseen"
Jay Sean - "Incomplete"
Joey Trap - "BRACE"
Jon Batiste - "Cry"
KAROL G, Anuel AA & J Balvin - "LOCATION"
K. Forest - "Summer We Never Had"
Kelly Rowland - "Black Magic"
Kevin Gates - "Plug Daughter 2"
KIDZ BOP Kids - "Levitating"
Killstation - "SPIRALIA"
Klass Murda & Benny the Butcher - "Theme Song"
Landon Cube, lil rxspy & SypSki - "Down & Out"
LPB Poody - "Batman"
Like Saturn - "vanished years"
Lil Gnar - "Missiles" ft. Trippie Redd
Lil Mosey - "Enough"
Lil Playah - "you THINK I CARE!"
Lil Tjay & 6LACK - "Calling My Phone"
lilspirit - "4ever"
Lucki - "Greed" ft. Lil Yachty
Luclover & Tes X - "Speedracer"
Luh Kel - "I Wish"
Mariah Carey - "We Belong Together (Mimi’s Late Night Valentine’s Mix)"
Mario - "Luxury Love"
Maude Latour - "Walk Backwards"
Maye - "Yours"
Men I Trust - "Tides"
Mýa - "Forever My Love"
Ninajirachi & Kota Banks - "Secretive!"
​nothing,nowhere. - "upside down"
P!nk & Willow Sage Hart - "Cover Me in Sunshine"
Paycheck - "WHERE'S THE LOVE?"
PJ Harding & Noah Cyrus - "Dear August"
PROFF - "Dark Magic"
ProfJam - "Alguém Como Tu" ft. Agir
Quinn XCII - "my​ wife & 2 dogs"
RiFF RAFF x DJ Paul x Merkules - "CUP CUP CUP"
Riley Pearce - "Golden Retriever"
Roosevelt - "Lovers"
ROSIE - "Retail Therapy"
Rowdy Rebel - "Jesse Owens" ft. NAV
Ryan Hurd - "Chasing After You" ft. Maren Morris
Sabina Ddumba - "Damn Good Woman"
SACHI - "Take Me Back"
Sara Kays - "Future Kids"
Savannah Cristina - "Body Work"
Scarypoolparty - "Home"
Sea Girls - "Nothing Breaks Like a Heart"
Sevyn Streeter, Chris Brown & A$AP Ferg - "Guilty"
Sharon Van Etten - "On Your Way Now"
Shy Glizzy - "White Lie" ft. RMR
Sir Sly - "Loverboy"
Sir Sly - "thx."
Skizzy Mars - "Pro Bad Decision Maker"
Sophie and the Giants - "Right Now"
Stalking Gia - "Worship"
Stunna Girl - "Still Smoke"
Surf Mesa & Madison Beer - "Carried Away"
Syd - "Missing Out"
Taylor Swift - "Love Story (Taylor's Version)"
The Fratellis - "Need a Little Love"
Theia - "CREEP" ft. Vayne
Tokyo Jetz - "WYTD" ft. Toosii
Trey Songz - "Brain"
UPSAHL - "STOP!"
valentina cy - "Love Me Now"
Victoria Justice - "Stay"
Warhol.SS - "Checks"
We Are The Empty - "The Ocean"
Weathers - "Losing Blood"
Wolfgang Gartner - "Cosa Nostra"
X Ambassadors & Jensen McRae - "skip.that.party"
YNW Bortlen - "Lovey Dovey" ft. Toosii
Young M.A - "Off the Yak"
Young Thug - "That Go!" ft. T-Shyne & Meek Mill
Yungeen Ace - "All in All"
Zachary Knowles - "johnny & june"
2/13
Aaron Cartier - "You Too"
Care - "Sun Hello to the Islands for Me"
Sol Jay - "#RULEZ"
Terror Jr - "Too Soon" ft. Shawn Wasabi
2/14
904TEZZO - "Here to Stay"
Airospace - "Cosmic Void"
Anirudh Ravichander - "Rendu Kaadhal"
Bobby V - "Reply"
Chuu - "좋아서 그래 (Hello)"
Digga D - "Toxic"
IRENE - "흰 밤 (A White Night)"
Joey Purp & KAMI - "FOR YOU"
Kevinhilfiger - "haunt u"
MAJ - "Queen"
Peniel - "Valentine"
PewDiePie - "Coco"
SuperMega - "Brand New Shirt"
2/15
CHEEZE - "아이 (Daydream)"
Dessa - "Bombs Away"
Helix tears - "idku" ft. Blxty, Yurms, Chava, blackwinterwells, Capoxxo, 8485 & SEBii
Kalan.FrFr. - "No Love" ft. Cypress Moreno & Mozzy
KUURO & Goja - "Close to Hell"
Moses Boyd & Katy B - "2 Far Gone (Remix)"
SOYOU - "ZERO:ATTITUDE" ft. IZ*ONE & pH-1
Wallows - "Quarterback"
ZIA - "누군가의 무엇이 되어 (I become love to you)"
2/16
Alfie Templeman - "Everybody's Gonna Love Somebody"
Dad Sports - "nrvs again"
Dawn Richard - "Bussifame"
Eunkwang - "왜, 너만 (Why’d You Leave Me)"
Ex:Re & 12 Ensemble - "Where the Time Went (Remix)" ft. Josephine Stephenson
Hayley Mary - "Would You Throw a Diamond"
Kang Daniel - "PARANOIA"
Lil Lotus - "Girl Next Door"
Lil Peppa & Buzzboi - "Cheez Crackerz (Remix)"
Lil Peppa & Buzzboi - "Just One Sock (Remix)"
Lil Peppa & Lil Grillz "FF"
Lost Girl - "Menneskekollektivet" ft. Håvard Volden & Jenny Hval
Lost Horizons - "Heart of a Hummingbird" ft. KookieLou
Nick Hakim - "QADIR (BADBADNOTGOOD Remix)"
Porridge Radio & piglet - "Let's Not Fight!"
Porridge Radio & piglet - "Strong Enough"
Rusty Cage - "Hollow Men"
SEBii - "breakOUT"
Toth - "Turnaround (Cocaine Song)"
Wild Pink - "Pacific City"
Your Old Droog & Tha God Fahim - "Slam Dunk Contest" ft. Pharoahe Monch
YOZOH - "작은 사람 (Weak People)"
2/17
AJR - "Way Less Sad"
Arm's Length - "No Sleep"
Christine and the Queens - "Would I Lie to You?" ft. Manu Payet
COBRAH - "DIP 'N' DRIP"
Crowded House - "To The Island"
D Imman - "Yaazha Yaazha"
Genesis Owusu - "Gold Chains"
Gojira - "Born for One Thing"
Iceage - "Vendetta"
José González - "El Invento"
LightSkinKeisha - "FDH"
Mahalia - "Jealous" ft. Rico Nasty
Mariah Carey - "We Belong Together (Mimi's Late Night Valentine's Mix) "
Maty Noyes - "Alexander"
Problem & Wiz Khalifa - "4 the Low"
serpentwithfeet - "Same Size Shoe"
Shura - "obsession" ft. Rosie Lowe
Stereolab - "The Super It"
The Antlers - "Just One Second"
THE BLOSSOM - "HARDCORE HAPPY"
TRI.BE - "둠둠다 (DOOM DOOM TA)"
TRI.BE - "Loca"
Unlike Pluto - "Zoned Out in My Youth"
Vindata - "Good 4 Me"
Vindata - "Union"
Vintage & Morelli x Arielle Maren - "Dreamers"
2/18
Isak Danielson - "If You Ever Forget That You Love Me"
KAYTRANADA - "Caution"
King Gizzard & the Lizard Wizard - "Pleura"
Koven - "Numb"
Koven - "Worlds Collide (Grafix Remix)"
Rack - "Davay"
Major Lazer & Ludmilla - "Pra Te Machucar"
Manchester Orchestra - "Bed Head"
MAY-A - "Time I Love To Waste"
NF - "CLOUDS"
Paloma Mami - "Religiosa"
Tom Odell - "numb"
Ulrikke - "Falling Apart"
Velafire - "Under Me"
2/19
24kGoldn - "3, 2, 1"
637godwin - "High Life"
6ix9ine - "ZAZA"
Adelén - "Jaded"
Alan Walker & salem ilese - "Fake a Smile"
Alice Phoebe Lou - "Dirty Mouth"
Amy Shark - "Love Songs Ain't for Us" ft. Keith Urban
Anx & 916frosty - "All American Rejects"
Aston Merrygold - "Share a Coke"
Babygirl - "You Were in My Dream Last Night"
Bella Thorne - "Shake It"
Benny the Butcher & Elcamino - "Immunity"
BFB da Packman - "Honey Pack (Remix)" ft. Lil Yachty & DDG
Big $tunt - "Money Gang" ft. Pooh Shiesty
BIGBABYGUCCI - "Seeing Ghosts"
Blac Chyna - "Doom" ft. Asian Doll
Black Honey - "Disinfect"
BMW KENNY - "HAHA"
Brent Ewing & Zoey Dollaz - "The Fall"
Budjerah - "Higher"
Camden Cox - "Under the Water"
Cash Cash - "Too Late" ft. Wiz Khalifa & Lukas Graham
Catie Turner - "Hide and Seek"
Charlotte Jane - "Down Days"
Chris Brown & Young Thug - "Go Crazy (Remix)" ft. Latto, Lil Durk & Future
CLEWS - "Want You That Way"
Clinton Kane - "CHICKEN TENDIES"
Cochise - "Usopp"
Coi Leray - "No More Parties (Remix)" ft. Lil Durk
Conan Gray - "Overdrive"
DaBaby - "Beatbox Freestyle"
Dami Im - "Lonely Cactus"
Danny Quest & Cheat Codes - "That Feeling" ft. Hayley May
David Shawty - "bad bye"
Day Sulan & YG - "Bailar"
Denzel Curry, Kenny Beats & Smino - "So.Incredible.pkg (Robert Glasper Version)" ft. Robert Glasper
Desto Dubb - "BNB" ft. Lil Pump
Dimitri Vegas & Like Mike, DVBBS & Roy Woods - "Too Much"
Drippin' So Pretty - "18"
ELHAE - "Separated"
ELIO - "CHARGER (Remix)" ft. Charli XCX
Ella Henderson & Tom Grennan - "Let's Go Home Together"
Emily Weisband - "New Salt"
Friedberg - "Midi 8"
Funkmaster Flex & Jadakiss - "Damn Shame"
Gianni Kosta & Dragonette - "Phantom"
GLADES - "Dancing in the Mirror"
Grace Davies - "​i met a boy online"
hololive IDOL PROJECT - "あすいろClearSky (AsuiroClearSky)" ft. Tokoyami Towa, Shiranui Flare, Sakura Miko, Ookami Mio, Minato Aqua, Natsuiro Matsuri, Aki Rosenthal, Yozora Mel & Roboco
Jake Miller - "ADDERALL"
Janine - "Loving Me"
Julia Gargano - "You Don't Get To"
Justine Skye - "Intruded"
Kembe X - "Under Pressure (The Smoking Peanut)"
Kenny Mason - "Partments"
KIDDO - "My 100"
L.L.A.M.A, Ne-Yo & Carmen DeLeon - "Shake"
Like Saturn - "free roaming"
Lil Yachty - "Hit Bout It" ft. Kodak Black
LocateEmilio & 27CLUB - "runny nose"
Lord Huron - "Not Dead Yet"
Lxst - "Famous"
Matt Ox - "Shivers"
Marshmello & Arash - "Lavandia"
Matt Berninger - "Let It Be"
MELVV - "READY OR NOT" ft. umru & Terror Jr
Memo600 & Only The Family - "Pistol Tottin"
Mike Shinoda - "Happy Endings" ft. UPSAHL & iann dior
Mimoza - "Young Queen"
MUST DIE! - "SORROW TECH"
Olivia Holt - "Do You Miss Me"
OMB Peezy - "Love is Blind"
Paris Texas - "HEAVY METAL"
Paul Woolford & Amber Mark - "HEAT"
Polish Club - "Stop For a Minute"
Powfu, Rxseboy & Sarcastic Sounds - "the way that you see me" ft. Ayleen Valentine
PRETTYMUCH - "Lonely"
Purple Disco Machine - "Fireworks" ft. Moss Kena & The Knocks
Rah Swish - "A Year Ago"
Rebecca Ferguson - "No Words Needed" ft. Nile Rodgers
Russ - "MISUNDERSTOOD"
Sandro Cavazza & Georgia Ku - "Love To Lose"
Semetary - "NECROMANSER"
Sipho the Gift - "Do More"
Sophia Messa - "Not That Kind of Love"
Still Woozy - "Rocky"
Space Tyger - "Satellites"
Surf - "Parlay"
Tainy & Miguel - "Sunbathe"
The Strumbellas - "Greatest Enemy"
Tory Lanez & Chris Brown - "F.E.E.L.S."
Transviolet - "Drugs in California"
Virgil Abloh - "Delicate Limbs (Omar S Remix)"
Walker Hayes - "I Hope You Miss Me"
Xan Griffin - "S.I.M.P.I.N.G."
Young Dolph & Key Glock - "Case Closed"
Buppy. - "Open My Letter"
2/20
kurtains - "axel ocelot"
2/22
神聖かまってちゃん (Shinsei Kamattechan) - "僕の戦争 (Boku no Sensou)"
Becky G & Burna Boy - "Rotate"
Billie Eilish - "ilomilo (Live)"
Cold Hart - "Every Day's a Day"
Dayglow - "Something"
Duke Deuce - "SPIN" ft. Foogiano
Eptic - "Shadow People"
Green Day - "Here Comes the Shock"
Joey Trap - "YUCA"
Nekomata Okayu - "もぐもぐYUMMY! (Mogu Mogu YUMMY!)"
Zara Larsson - "Look What You've Done"
2/21
Architects - "Meteor"
Luba Juice - ''Who'' ft. King Andi3
2/23
Adult Mom - "Checking Up"
​cupcakKe - "Back In Blood (Remix)"
Dropkick Murphys - "Middle Finger"
Fred again.. & The Blessed Madonna - "Marea (We've Lost Dancing)"
Glass Beach - "yoshis island (world 7x7 mix)"
Greentea Peng - "Nah It Ain't the Same"
Gutta100 - "Beatbox (Remix)"
Jade Bird - "Open up the heavens"
Jetty Bones - "Nothing"
JID - "Skegee"
Lael Hansen - "rip2me"
Pussy Riot - "TOXIC" ft. Dorian Electra
Shamir - "Ocean Eyes"
SUNMI - "꼬리 (Tail)"
SUNMI - "꽃같네 (What the Flower)"
SURAN - "Sunny"
2/24
2KBABY - "No More Parties (Remix)"
Alex Porat - "girlfriend"
Aodhan - "I'm Closed"
Baby Queen - "These Drugs"
Bright Eyes - "Flirted With You All My Life"
Caleborate & Kota the Friend - "Contact"
Cautious Clay - "Roots"
CHAI - "Maybe Chocolate Chips" ft. Ric Wilson
Elena Tsagrinou - "El Diablo"
ELHAE - "Fun Fact Ballad"
Half Waif - "Party's Over"
James Vickery - "Come to Me" ft. Musiq Soulchild
​​​J​ao - "Coringa"
Julien Baker - "Heatwave"
Kero Kero Bonito - "The Princess and the Clock"
Liyah Knight & Nerve - "Cheers"
Muki - "I Make Boys Cry"
renforshort - "virtual reality"
Sinéad Harnett - "Last Love"
Starrah - "Miss This"
THE BOYZ - "Breaking Dawn"
The Offspring - "Let the Bad Times Roll"
The Vaccines - "Fire"
THEY. - "Count Me In (Remix)" ft. Kiana Ledé
Tom Aspaul - "Tender 2" ft. Funk LeBlanc
Vaundy - 融解sink
Will Mannay - "No Feelings"
Wolf Alice - "The Last Man on Earth"
2/25
Bleu Clair - "The Tempo"
Cosha & Coby Sey - "Tighter"
Mansionair - "MORE"
Nick Jonas - "Spaceman"
NSG - "Drunk Guitar (Remix)" ft. Potter Payper
Owlle - "Sounds Familiar"
Peach PRC - "Josh"
Post Malone - "Only Wanna Be with You"
Steps & Michelle Visage - "Heartbreak in This City (Remix)"
Tiana Blake - "Interruption"
Yeek - "Valencia"
2/26
22Gz - "Blixky Gang Freestyle, Pt. 2"
27CLUB - "Crushin'"
2KBABY & Marshmello - "Like This"
6 Dogs - "Starfire (Teen Titans)"
A.CHAL - "Nobody Like Me"
Alesso & Armin Van Buuren - "Leave a Little Love"
Alexandra Stan - "Aleasa"
Aleyna Tilki - "Retrograde"
Alice Longyu Gao - "She Abunai" ft. Mura Masa & bülow
Aloe Blacc - "Other Side"
Alyssa Joseph - "sadboy"
​anders - "Late to the Party"
Ant Saunders - "Spoiled"
Aries - "DITTO"
Ben Howard - "Far Out"
Ben Howard - "Follies Fixture"
Billy Davis - "Dream No More" ft. Ruel & Genesis Owusu
Bizness Boi & Symphani Soto - "I’m Witchu"
braveweather - "black&white"
BRELAND - "Cross Country"
Brett Young - "You Got Away with It"
Carrie Underwood - "Great is Thy Faithfulness" ft. CeCe Winans
Cavetown - "Paul"
CHEETAH - "Villain" ft. JAMIE
Cinders - "Growing Up"
Claire Rosinkranz - "Parking Lot"
Claire Rosinkranz - "Real Life"
Claudia Leitte - "Agradece"
Curtis Waters - "Conceited"
Dava - "New Ceilings"
DDG & OG Parker - "Money Long" ft. 42 Dugg
Denzel Curry & Kenny Beats - "’ Cosmic ’ .m4a (The Alchemist Version)" ft. Joey Bada$$
dePresno - "Church"
Divided Minds - "Wake Up"
DJ Topgun - "Sleep" ft. David Shawty & BBY GOYARD
Doll Skin - "Control Freak"
DOOLIE - "Woke Up Feeling Dramatic"
Ella Vos & Mokita - "​still dreaming, backwards"
Elle King & Miranda Lambert - "Drunk (And I Don't Wanna Go Home)"
Elliphant - "Drunk & Angry"
Enisa - "Count My Blessings"
EVAN GIIA - "Stay Up"
FCG Heem - "More Pain" ft. Toosii
Florrie - "Hours"
Frances - "Ocean in Gold"
Frances - "Rare"
Futuristic & Michael Minelli - "Know Me"
GARZI - "PARANOIA"
Greta Isaac - "Like Me"
H.E.R. & Justin Credible - "Damage (Justin Credible Remix)"
Hanne Leland - "Even If It Breaks My Heart"
Hotboii - "Fuck Shit"
IDK - "Just Like Martin"
India Shawn - "Too Sweet" ft. Unknown Mortal Orchestra
Jaguar Jonze - "CURLED IN"
Jazmine Flowers - "Awkward"
Joel Corry, RAYE & David Guetta - "BED"
John-Robert - "Damn Bean"
Josie Man - "Cuts & Bruises"
Joyce Wrice - "On One" ft. Freddie Gibbs
Kamrin Houser - "G-Code" ft. Lil Skies
Key Glock - "I'm the Type"
Kitten - "American Football"
Kristen Hanby - "Good Girl" ft. YBN Nahmir
KYLE - "But Cha" ft. Josh Golden
Lauren Daigle - "Hold On To Me"
Leon Bridges & Keite Young - "Like a Ship"
Like Saturn - "missing summer"
Lil Kapow - "No Headlights"
Lunay - "Sin Ropa"
Maisie Peters - "John Hughes Movie"
Magnolia Park - "Back on My Bullshit" ft. Jake Hill
Martin Jensen & Georgia Ku - "2019"
Mat Kearney - "Pontiac"
MDMA (Molly) - "Hills"
Millie Turner - "Concrete Tragedy"
MOL$ - "TEN FOLD" ft. MC Virgins & Lil Force
Morcheeba - "Oh Oh Yeah"
Nessly - "Link and Build" ft. MadeinTYO
Noname - "Rainforest"
Nuski2Squad - "Gone Too Soon" ft. Toosii
Peder Elias - "Best Friend"
Pop Smoke - "AP"
Quelly Woo - "PAIN INTO PASSION"
R3HAB, Fafaq & DNF - "Ringtone"
Rah Swish - "Warm Ups" ft. Leeky G Bando
Royal & the Serpent - "​i can't get high"
Sarah Close - "Forgive or Forget"
Sasha Keable - "Exception"
Shelley FKA DRAM - "Exposure"
SIX60 - "All She Wrote"
Slayyyter - "Clouds"
Sol Jay - "fatal"
SpotEmGottem - "Beat Box 3" ft. DaBaby
SSGKobe - "Tired of Me"
Steele 11 - "like dat!"
Steve Aoki & George Benson - "Give Me the Night"
Suigeneris - "Hennyclaws"
Surf - "Beyoncé"
Surf - "To The Moon"
SVEA & Call Me Loop - "I'll Get Better"
Sycco - "My Ways"
Tank - "Can't Let It Show"
Tee Grizzley - "Robbery Part Two"
Tilian - "Anthem"
The Band CAMINO - "1 Last Cigarette"
The Kid LAROI - "STILL CHOSE YOU" ft. Mustard
Thomston - "JPA989"
Tom Speight - "Strange Days"
Torine - "Bored"
TRAQULA - "Cheat Codes for Hoes (Remix)" ft. Shotgun Willy
Two Feet - "Never Enough"
Tyla Yaweh - "All the Smoke (Elias Remix)" ft. Gunna, Wiz Khalifa & Elias
Vacation Forever - "Pop Up In My Head"
William Singe - "Talk to Me Nice"
XIX - "Toxic" ft. BENKRO
YG - "Go Big" ft. Big Sean
YSN Flow - "Bottom Boy"
Yung Bae - "Disco Body Parts" ft. AWOLNATION
Yung Bleu - "Thieves in Atlanta" ft. Coi Leray
Zak Abel - "Be Kind"
2/27
Dotter - "Little Tot"
Eric Saade - "Every Minute"
The Stupendium - "The Apex" ft. NemRaps
2/28
J Balvin - "Ma' G"9Embed